fffff-.....--^-f-fff
-f....-ff--..-^f--ff
^----fffff----^^-fff
-^-..-...^f-f....--^
------....--fff--^^-
--^^ff--...---ff^^-f
f--^^^----ff-----..-
-f..-f^^---....---^f
.....---^^--f---fff-